NO ./texture/path_to_the_north_texture.xpm
SO ./texture/path_to_the_south_texture.xpm
WE ./texture/path_to_the_west_texture.xpm
EA ./texture/path_to_the_east_texture.xpm

C 102,204,255
F 102,51,0
   
1111111111111111111111111
10000001 1110000000000001
1011000111110000000000001
1001000000000000000000001
11111111101100001110000001111111
10000000011100001110111111111111
1111011111 110011100000010001
11110111111111111111101111111
11000000110101011100000010001
10E00000000000000000000000001
10000000000000001101010010001
11111111111111111111111111111
1                           1
11111111111111111111111111111
1100000111010101111101111000111
11110101 1110101 101111010001
11111111 1111111 111111111111
       1
       1
       1
       1